32 32
80 80
4
1000 400 1 1000 50 90 2 50 100
200 160 2 1200 40 90 4 50 100
800 200 2 1400 20 80 6 70 200
360 320 1 1600 10 80 1 20 120
2 2 2 2 2 2 2 2 2 2 2 2 2 2 2 2 2 2 2 2 2 2 2 2 2 2 2 2 2 2 2 2
2 0 0 0 0 0 0 0 0 0 0 0 0 0 0 0 0 0 0 0 0 3 1 0 0 0 1 1 0 1 1 2
2 0 0 1 0 0 1 1 0 0 0 1 2 0 0 0 0 0 0 0 0 3 1 1 1 1 1 1 1 1 1 2
2 0 0 0 1 0 0 0 0 1 0 1 0 0 0 0 0 1 0 0 0 3 1 1 0 0 0 0 1 0 1 2
2 0 0 0 0 1 0 0 0 1 0 0 0 0 0 0 0 0 0 0 0 3 1 1 1 1 1 1 1 1 1 2
2 0 0 1 0 0 0 3 0 0 0 0 0 0 1 0 1 0 0 0 0 3 3 3 3 3 3 3 1 3 3 2
2 0 0 0 3 3 3 3 0 0 0 1 0 0 0 0 0 0 0 0 0 3 0 0 0 0 0 0 0 0 0 2
2 0 0 0 0 0 0 3 0 0 1 0 0 0 0 0 0 0 0 0 0 3 0 0 0 0 0 0 0 0 0 2
2 0 1 1 1 0 0 0 0 0 0 0 1 0 0 0 0 0 0 0 0 0 0 0 0 0 0 0 0 0 0 2
2 0 0 0 0 0 0 1 0 0 3 0 1 0 0 0 0 1 1 0 1 0 0 0 0 1 0 0 0 0 0 2
2 0 0 1 0 0 3 0 0 0 3 0 0 0 0 1 0 0 2 1 1 0 0 0 0 0 0 0 0 0 0 2
2 0 0 0 0 0 3 0 1 0 3 0 0 3 0 0 0 1 1 0 1 0 0 0 0 1 1 1 0 0 0 2
2 0 1 0 0 0 3 0 0 0 3 0 0 3 0 0 0 0 1 1 1 0 0 0 0 0 0 0 0 0 0 2
2 3 3 3 3 3 3 3 3 3 3 3 3 3 3 0 0 0 0 0 0 0 0 1 1 0 0 0 0 0 0 2
2 0 0 0 0 0 0 3 0 0 0 0 0 0 0 0 0 0 0 0 0 0 0 0 0 0 0 0 1 1 0 2
2 0 0 1 1 0 0 3 0 0 0 0 1 0 0 1 0 0 0 0 0 0 0 0 0 0 0 1 0 0 0 2
2 0 0 0 0 0 0 3 0 1 0 0 0 0 0 0 0 0 0 1 0 1 0 0 0 0 0 0 0 0 0 2
2 0 1 0 0 0 0 3 0 0 0 1 0 0 0 1 1 0 1 0 0 0 0 0 0 1 1 0 0 0 0 2
2 0 3 3 3 3 3 3 0 0 0 0 0 0 0 0 0 0 0 0 0 0 0 0 0 0 0 0 0 0 0 2
2 0 0 0 0 0 0 3 0 0 0 0 1 0 0 0 0 0 0 0 0 0 1 1 0 0 0 1 1 1 0 2
2 3 3 3 3 3 0 3 0 0 0 0 0 0 1 0 0 1 0 0 1 0 0 0 0 0 0 0 0 0 0 2
2 0 0 1 0 0 0 3 3 3 3 3 3 3 3 3 3 3 3 3 1 3 3 3 3 3 3 3 3 3 3 2
2 0 0 0 0 1 0 0 0 3 0 0 0 3 0 0 0 0 0 0 0 0 0 0 0 0 0 3 0 3 0 2
2 0 0 0 1 0 0 0 0 3 0 1 0 3 0 3 3 3 3 3 3 1 3 3 0 0 0 3 0 3 0 2
2 0 3 3 3 3 0 0 0 3 0 1 0 3 0 0 0 0 0 0 0 0 0 0 0 0 0 3 0 3 0 2
2 0 0 3 0 3 0 0 0 1 0 0 0 3 0 0 0 3 0 0 0 0 0 0 0 0 0 3 0 0 0 2
2 0 0 3 0 3 0 0 0 3 0 0 0 3 0 0 0 3 0 0 0 0 0 0 0 0 0 3 3 0 0 2
2 0 0 1 1 3 1 0 0 3 0 0 0 3 0 0 0 3 3 3 3 3 3 1 3 3 3 3 0 0 0 2
2 0 0 3 0 3 0 0 0 0 0 0 0 3 0 0 0 3 0 0 0 0 0 0 0 0 0 0 0 0 0 2
2 0 0 3 0 3 0 0 0 0 3 3 3 3 3 3 0 3 0 0 0 0 0 0 0 0 0 0 0 0 0 2
2 0 0 3 0 3 0 0 0 0 0 0 0 0 0 0 0 3 0 0 0 0 0 0 0 0 0 0 0 0 0 2
2 2 2 2 2 2 2 2 2 2 2 2 2 2 2 2 2 2 2 2 2 2 2 2 2 2 2 2 2 2 2 2